#####################
#x........+........x#
#+++.....u+......+++#
#......++++.........#
#...........+++....u#
#...+++............x#
#........+++..++++++#
#.........o.........#
#++++....+..........#
#........+..........#
#...................#
#..........o........#
#.......+++++++.....#
#.x....++++++.......#
#.......x...........#
#...................#
#+..+..............x#
#####################

//fiendeSpawns: 4
//spelarSpawns: 1
//powerupSpawns: 2
//bredd: 22
//höjd: 10
